25
25
15
23
1111111111111111111111111
1000000000000000000000001
1000000000000000000000001
1000000000000000000000001
1000000000000000000000001
1000000000000000000000001
1000000000000000000000001
1000000000000000000000001
1000000000000000000000001
1000000000000000000000001
1000000000000000000000001
1000000000000000000000001
1000000000000000000000001
1000000000000000000000001
1000000000000000000000001
1000000000000000000000001
1000000000000000000000001
1000000000000000000000001
15555b5055555555555555551
1000005000000000000000001
1000005000000000000000001
1000005000000008000000001
1000005000000000000000001
1000005000000000000000001
1111111111111111111111111
      size_x
      size_y
      start_x
      start_x
